border_size=1
usage=map

Gg, Gg, Rd, Rd, Rd, Rd, Rd, Rd, Rd, Rd, Rd, Rd, Rd, Rd, Rd, Rd, Rd, Rd, Rd, Rd, Rd, Rd, Rd^Fds, Gg, Gg, Gg, Rd, Rd, Rd, Rd, Rd, Rd, Rd^Fds, Rd^Fds, Rd^Fds, Rd^Fds, Rd^Fds, Rd, Rd, Rd, Ch, Ch, Ch, Rd, Rd, Rd
Rd, Rd, Rd, Rd, Rd, Rd, Rd^Fds, Rd^Fds, Rd^Fds, Rd, Rd^Fds, Rd^Fds, Rd^Fds, Rd^Fds, Rd^Fds, Rd^Fds, Rd^Fds, Rd^Fds, Rd^Fds, Rd^Fds, Rd^Fds, Rd^Fds, Rd^Fds, Rd^Fds, Rd^Fds, Rd, Rd, Rd, Rd, Rd, Rd^Fds, Rd^Fds, Rd^Fds, Rd^Fds, Rd^Fds, Rd^Fds, Rd^Fds, Rd, Rd, Ch, Cha, Ch, Ch, Ch, Rd, Rd
Rd, Rd, Rd, Rd, Rd, Rd^Fds, Rd^Fds, Rd^Fds, Rd^Fds, Rd^Fds, Rd^Fds, Rd^Fds, Rd^Fds, Rd^Fds, Rd^Fds, Rd^Fds, Rd^Fds, Rd^Fds, Rd^Fds, Rd^Fds, Rd^Fds, Rd^Fds, Rd^Fds, Rd^Fds, Rd^Fds, Rd^Fds, Rd, Rd, Rd, Rd^Fds, Rd^Fds, Rd^Fds, Rd^Fds, Rd^Fds, Rd^Fds, Rd^Fds, Rd^Fds, Rd, Rd, Ch, Ch, 2 Kh, Ch, Ch, Rd, Rd
Rd, Rd, Rd^Fds, Rd, Rd^Fds, Rd^Fds, Rd^Fds, Rd^Fds, Rd^Fds, Rd^Fds, Rd^Fds, Rd^Fds, Rd^Fds, Rd^Fds, Rd^Fds, Rd^Fds, Rd^Fds, Rd^Fds, Rd^Fds, Rd^Fds, Rd^Fds, Rd^Fds, Rd^Fds, Rd^Fds, Rd^Fds, Rd^Fds, Rd, Rd, Rd, Rd^Fds, Rd^Fds, Rd^Fds, Rd^Fds, Rd^Fds, Rd^Fds, Rd^Fds, Rd, Rd, Rd, Ch, Ch, Ch, Ch, Ch, Rd, Rd
Rd^Fds, Rd^Fds, Rd^Fds, Rd^Fds, Rd, Rd^Fds, Mm^Fds, Mm^Fds, Mm^Fds, Rd^Fds, Mm^Fds, Rd^Fds, Rd^Fds, Rd^Fds, Rd^Fds, Rd^Fds, Rd^Fds, Rd^Fds, Rd^Fds, Rd^Fds, Rd^Fds, Rd^Fds, Rd^Fds, Rd^Fds, Rd^Fds, Rd^Fds, Rd, Rd, Rd, Rd^Fds, Rd^Fds, Rd^Fds, Rd^Fds, Rd^Fds, Rd^Fds, Rd^Fds, Rd^Fds, Rd, Rd^Fds, Rd, Rd, Ch, Rd, Rd, Rd, Rd
Rd, Rd^Fds, Rd^Fds, Rd, Rd^Fds, Mm, Mm, Mm^Fds, Mm^Fds, Mm^Fds, Mm^Fds, Mm^Fds, Mm^Fds, Rd^Fds, Mm^Fds, Rd^Fds, Rd^Fds, Rd^Fds, Rd^Fds, Rd^Fds, Rd^Fds, Rd^Fds, Rd^Fds, Rd^Fds, Rd^Fds, Rd^Fds, Rd, Rd, Rd, Rd^Fds, Rd^Fds, Rd^Fds, Rd^Fds, Rd^Fds, Rd^Fds, Rd^Fds, Rd^Fds, Rd^Fds, Rd^Fds, Rd^Fds, Rd^Fds, Rd^Fds, Rd^Fds, Rd^Fds, Rd^Fds, Rd^Fds
Rd, Rd, Rd, Rd^Fds, Rd, Mm^Fds, Mm^Fds, Mm^Fds, Mm^Fds, Mm^Fds, Mm^Fds, Mm^Fds, Mm^Fds, Mm^Fds, Mm^Fds, Mm^Fds, Mm^Fds, Mm^Fds, Mm^Fds, Rd^Fds, Rd^Fds, Rd^Fds, Rd^Fds, Rd^Fds, Rd, Rd, Rd, Rd, Rd, Rd, Rd, Rd^Fds, Rd^Fds, Rd^Fds, Rd^Fds, Rd^Fds, Rd^Fds, Rd^Fds, Rd^Fds, Rd^Fds, Rd^Fds, Rd^Fds, Rd^Fds, Rd^Fds, Rd^Fds, Rd^Fds
Rd, Rd, Rd, Rd, Rd, Mm, Mm, Mm, Mm, Mm^Fds, Mm^Fds, Mm^Fds, Mm^Fds, Mm^Fds, Mm^Fds, Mm^Fds, Mm^Fds, Mm^Fds, Mm^Fds, Mm^Fds, Mm^Fds, Mm^Fds, Mm^Fds, Rd, Mm, Rd, Rd, Rd, Rd, Rd, Rd, Rd^Fds, Rd^Fds, Rd^Fds, Rd^Fds, Rd^Fds, Rd^Fds, Rd^Fds, Rd^Fds, Rd^Fds, Rd^Fds, Rd^Fds, Rd^Fds, Rd^Fds, Rd^Fds, Rd^Fds
Rd, Rd, Rd, Rd, Rd, Rd, Rd, Mm, Mm, Mm^Fds, Mm^Fds, Mm^Fds, Mm^Fds, Mm^Fds, Mm^Fds, Mm, Mm, Mm^Fds, Mm^Fds, Mm^Fds, Mm^Fds, Mm^Fds, Mm^Fds, Mm, Mm, Mm, Mm, Rd, Mm, Rd, Rd, Rd, Rd, Rd^Fds, Rd^Fds, Rd^Fds, Rd^Fds, Rd^Fds, Rd^Fds, Rd^Fds, Rd^Fds, Rd^Fds, Rd^Fds, Rd^Fds, Rd^Fds, Rd^Fds
Rd, Rd, Rd, Rd, Rd, Rd, Rd, Rd, Rd, Mm^Fds, Mm^Fds, Mm^Fds, Mm^Fds, Mm^Fds, Mm, Mm, Mm, Mm^Fds, Mm^Fds, Mm^Fds, Mm^Fds, Mm^Fds, Mm, Mm, Mm, Mm, Mm, Mm, Mm, Mm, Mm, Rd, Rd, Rd, Rd, Rd, Rd, Rd^Fds, Rd, Rd^Fds, Rd^Fds, Rd^Fds, Rd^Fds, Rd^Fds, Rd^Fds, Rd^Fds
Rd, Rd, Rd, Rd, Rd, Rd, Rd, Rd, Rd, Rd, Rd, Rd^Fds, Rd, Mm, Mm, Mm, Mm, Mm, Mm, Mm^Fds, Mm, Mm, Mm, Mm, Mm, Mm, Mm, Mm, Mm, Mm, Mm, Mm, Rd, Rd, Rd, Rd, Rd, Rd, Rd, Rd, Rd, Rd, Rd, Rd, Rd, Rd
Rd, Rd, Rd, Rd, Rd, Rd, Rd, Rd, Rd, Rd, Rd, Rd, Rd, Rd, Rd, Rd, Rd, Mm, Rd, Mm, Mm, Mm, Mm, Mm, Mm, Mm, Mm, Mm, Mm, Mm, Mm, Mm, Rd, Rd, Rd, Rd, Rd, Rd, Rd, Rd, Rd, Rd, Rd, Rd, Rd^Br/, Rd^Br/
Rd, Rd, Rd, Rd, Rd, Rd, Rd, Rd, Rd, Rd, Rd, Rd, Rd, Rd, Rd, Rd, Rd, Rd, Rd, Rd, Rd, Rd, Rd, Mm, Mm, Mm, Mm, Mm, Mm, Mm, Mm, Mm, Rd, Rd, Rd, Rd, Rd, Rd, Rd, Rd, Rd, Rd, Rd^Br/, Rd^Br/, Rd, Rd
Rd, Rd, Rd, Rd, Rd, Rd, Rd, Rd, Rd, Rd, Rd, Rd, Rd, Rd, Rd, Rd, Rd, Rd, Rd, Rd, Rd, Rd, Rd, Rd, Rd, Rd, Rd, Mm, Mm, Mm, Mm, Mm, Rd, Rd, Rd, Rd, Rd, Rd, Rd, Rd, Rd^Br/, Rd^Br/, Rd, Rd, Rd, Rd
Rd, Rd, Mm, Rd, Mm, Rd, Rd, Rd, Rd, Rd, Rd, Rd, Rd, Rd, Rd, Rd, Rd, Rd, Rd, Rd, Rd, Rd, Rd, Rd, Rd, Rd, Rd, Rd, Rd, Mm, Rd, Rd, Rd, Rd, Rd, Rd, Rd, Rd, Rd^Br/, Rd^Br/, Rd, Rd, Rd, Rd, Rd, Rd
Mm, Mm, Mm, Mm, Mm, Mm, Mm, Rd, Rd, Rd, Rd, Rd, Rd, Rd, Rd, Rd, Rd, Rd, Hh, Rd, Hh, Rd, Hh, Rd, Hh, Rd, Rd, Rd, Rd, Rd, Rd, Rd, Rd, Rd, Rd, Rd, Rd^Br/, Rd^Br/, Rd, Rd, Rd, Rd, Rd, Rd, Rd, Rd
Mm, Mm, Mm, Mm, Mm, Mm, Mm, Rd, Rd, Rd, Hh, Hh, Hh, Hh, Hh, Hh, Hh, Hh, Hh, Hh, Hh, Hh, Hh, Hh, Hh, Hh, Hh, Rd, Rd, Rd, Rd, Rd, Rd, Rd, Rd^Br/, Rd^Br/, Rd, Rd, Rd, Rd, Rd, Rd, Rd, Rd, Rd, Rd
Mm, Mm, Mm, Mm, Mm, Mm, Mm, Rd, Rd, Rd, Hh, Hh, Hh, Hh, Hh, Hh, Gs^Fds, Gs^Fds, Gs^Fds, Hh, Gs^Fds, Hh, Gs^Fds, Hh, Hh, Hh, Hh, Hh, Hh, Rd, Rd, Rd, Rd^Br/, Rd^Br/, Rd, Rd, Rd, Rd, Rd, Rd, Rd, Rd, Rd, Rd, Rd, Rd
Mm, Mm, Mm, Mm, Mm, Mm, Rd, Rd, Rd, Rd, Hh, Hh, Hh, Hh, Hh, Hh, Gs^Fds, Gs^Fds, Gs^Fds, Gs^Fds, Gs^Fds, Gs^Fds, Gs^Fds, Gs^Fds, Hh, Hh, Hh, Hh, Hh, Rd, Rd^Br/, Rd^Br/, Rd, Rd, Rd, Rd, Rd, Rd, Rd, Rd, Rd, Rd, Rd, Rd, Rd, Rd
Mm, Mm, Mm, Mm, Rd, Rd, Rd, Rd, Rd, Rd, Rd, Hh, Hh, Hh, Hh, Hh, Gs^Fds, Gs^Fds, Gs^Fds, Gs^Fds, Gs^Fds, Gs^Fds, Gs^Fds, Gs^Fds, Hh, Hh, Rd, Hh, Rd^Br/, Rd^Br/, Rd, Rd, Rd, Rd, Rd, Rd, Rd, Rd, Mm, Rd, Mm, Rd, Rd, Rd, Rd, Rd
Mm, Mm, Mm, Mm, Rd, Rd, Rd, Rd, Rd, Rd, Rd, Rd, Rd, Hh, Hh, Hh, Hh, Gs^Fds, Hh, Gs^Fds, Hh, Gs^Fds, Hh, Hh, Hh, Hh, Rd^Br/, Rd^Br/, Rd, Rd, Hh, Rd, Hh, Rd, Rd, Rd, Mm, Mm, Mm, Mm, Mm, Mm, Mm, Mm, Mm, Rd
Mm, Mm, Mm^Fds, Mm^Fds, Mm^Fds, Rd^Fds, Mm^Fds, Rd, Rd^Fds, Rd, Rd, Rd, Rd, Rd, Rd, Hh, Rd, Hh, Rd, Hh, Rd, Hh, Rd, Rd, Rd^Br/, Rd^Br/, Rd, Rd, Hh, Hh, Hh, Hh, Hh, Rd, Rd, Mm, Mm, Mm, Mm, Mm, Mm, Mm, Mm, Mm, Mm, Mm
Mm, Mm^Fds, Mm^Fds, Mm^Fds, Mm^Fds, Mm^Fds, Mm^Fds, Mm^Fds, Mm^Fds, Rd^Fds, Rd^Fds, Rd, Rd, Rd, Rd, Rd, Rd, Rd, Rd, Rd, Rd, Rd, Rd^Br/, Rd^Br/, Hh, Hh, Hh, Hh, Hh, Hh, Hh, Hh, Hh, Rd, Rd, Mm, Mm, Mm, Mm, Mm, Mm, Mm, Mm, Mm, Mm, Mm
Mm, Mm^Fds, Mm^Fds, Mm^Fds, Mm^Fds, Mm^Fds, Mm^Fds, Mm^Fds, Mm^Fds, Rd^Fds, Rd^Fds, Rd^Fds, Rd^Fds, Rd, Rd, Rd, Rd, Rd, Rd, Rd, Rd^Br/, Rd^Br/, Rd, Rd, Hh, Hh, Hh, Hh, Hh, Hh, Hh, Hh, Rd, Rd, Rd, Mm, Mm, Mm, Mm, Mm, Mm, Mm, Mm, Mm, Mm, Mm
Mm, Mm^Fds, Mm^Fds, Mm^Fds, Mm^Fds, Mm^Fds, Mm^Fds, Mm^Fds, Mm^Fds, Rd^Fds, Rd^Fds, Rd^Fds, Rd^Fds, Rd^Fds, Rd^Fds, Rd, Rd, Rd, Rd^Br/, Rd^Br/, Rd, Rd, Hh, Hh, Hh, Hh, Hh, Hh, Hh, Hh, Hh, Hh, Rd, Rd, Rd, Mm, Mm, Mm, Mm, Mm, Mm, Mm, Mm, Mm, Mm, Mm
Rd, Mm, Mm, Mm^Fds, Mm^Fds, Mm^Fds, Mm^Fds, Mm^Fds, Rd^Fds, Rd^Fds, Rd^Fds, Rd^Fds, Rd^Fds, Rd^Fds, Rd^Fds, Rd^Fds, Rd^Fds, Rd^Br/, Rd, Rd, Rd, Rd, Hh, Hh, Hh, Hh, Hh, Hh, Hh, Hh, Hh, Hh, Rd, Rd, Rd, Mm, Mm^Fds, Mm^Fds, Mm^Fds, Mm^Fds, Mm^Fds, Mm, Mm, Mm, Mm, Mm
Rd, Rd, Rd, Rd, Rd, Mm, Rd, Rd^Fds, Rd, Rd^Fds, Rd^Fds, Rd^Fds, Rd^Fds, Rd^Fds, Rd^Fds, Rd^Fds, Rd^Fds, Rd^Fds, Rd, Rd, Rd, Rd, Rd, Hh, Hh, Hh, Hh, Hh, Rd^Fds, Hh, Rd^Fds, Rd, Rd, Rd, Rd^Fds, Rd^Fds, Mm^Fds, Mm^Fds, Mm^Fds, Mm^Fds, Mm^Fds, Mm^Fds, Mm^Fds, Mm, Mm, Mm
Rd, Rd, Rd, Rd, Rd, Rd, Rd, Rd, Rd, Rd, Rd, Rd^Fds, Rd^Fds, Rd^Fds, Rd^Fds, Rd^Fds, Rd^Fds, Rd^Fds, Rd^Fds, Rd, Rd, Rd, Rd, Rd, Rd, Rd, Rd^Fds, Rd^Fds, Rd^Fds, Rd^Fds, Rd^Fds, Rd^Fds, Rd^Fds, Rd^Fds, Rd^Fds, Rd^Fds, Rd^Fds, Mm^Fds, Mm^Fds, Mm^Fds, Mm^Fds, Mm^Fds, Mm^Fds, Mm^Fds, Mm, Mm
Rd, Rd, Rd, Rd, Rd, Rd, Rd, Rd, Rd, Rd, Rd^Br/, Rd^Br/, Rd, Rd^Fds, Rd^Fds, Rd^Fds, Rd^Fds, Rd^Fds, Rd^Fds, Rd, Rd, Rd, Rd, Rd, Rd^Fds, Rd^Fds, Rd^Fds, Rd^Fds, Rd^Fds, Rd^Fds, Gll^Fp, Gll^Fp, Gll^Fp, Gll^Fp, Gll^Fp, Rd^Fds, Gll^Fp, Rd^Fds, Rd^Fds, Mm^Fds, Mm^Fds, Mm^Fds, Mm^Fds, Mm^Fds, Mm, Mm
Rd, Rd, Rd, Rd, Ch, Ch, Ch, Rd, Rd^Br/, Rd^Br/, Rd, Rd, Rd, Rd^Fds, Rd^Fds, Rd^Fds, Rd^Fds, Rd^Fds, Rd^Fds, Rd, Rd, Rd, Rd, Rd, Rd^Fds, Rd^Fds, Rd^Fds, Rd^Fds, Rd^Fds, Gll^Fp, Gll^Fp, Gll^Fp, Gll^Fp, Gll^Fp, Gll^Fp, Gll^Fp, Gll^Fp, Gll^Fp, Rd^Fds, Rd^Fds, Rd^Fds, Mm^Fds, Rd^Fds, Mm^Fds, Mm, Mm
Rd, Rd, Rd, Ch, Ch, Ch, Ch, Ch, Rd, Rd, Rd, Rd, Rd, Rd, Rd^Fds, Rd^Fds, Rd^Fds, Rd^Fds, Rd^Fds, Rd, Rd, Rd, Rd, Rd, Rd^Fds, Rd^Fds, Rd^Fds, Rd^Fds, Rd^Fds, Gll^Fp, Gll^Fp, Gll^Fp, Gll^Fp, Gll^Fp, Gll^Fp, Gll^Fp, Gll^Fp, Gll^Fp, Rd^Fds, Rd^Fds, Rd^Fds, Rd^Fds, Rd^Fds, Rd^Fds, Rd, Rd
Rd, Rd, Rd, Ch, Ch, 1 Kh, Ch, Ch, Rd, Rd, Rd, Rd, Rd, Rd, Rd^Fds, Rd^Fds, Rd^Fds, Rd^Fds, Rd^Fds, Rd^Fds, Rd^Fds, Rd, Rd, Rd, Rd^Fds, Rd^Fds, Rd^Fds, Rd^Fds, Rd^Fds, Gll^Fp, Gll^Fp, Gll^Fp, Gll^Fp, Gll^Fp, Gll^Fp, Gll^Fp, Gll^Fp, Gll^Fp, Rd^Fds, Rd^Fds, Rd^Fds, Rd^Fds, Rd^Fds, Rd^Fds, Rd, Rd
Rd, Rd, Rd^Br/, Ch, Ch, Ch, Ch, Ch, Rd, Rd, Rd, Rd, Rd, Rd, Rd^Fds, Rd^Fds, Rd^Fds, Rd^Fds, Rd^Fds, Rd^Fds, Rd^Fds, Rd, Rd, Rd, Rd, Rd^Fds, Rd^Fds, Rd^Fds, Rd^Fds, Rd^Fds, Rd^Fds, Gll^Fp, Gll^Fp, Gll^Fp, Gll^Fp, Gll^Fp, Rd^Fds, Rd^Fds, Rd^Fds, Rd^Fds, Rd^Fds, Rd^Fds, Rd, Rd, Rd, Rd
Rd^Br/, Rd^Br/, Rd, Rd, Rd, Ch, Rd, Rd, Rd, Rd, Rd, Rd, Rd, Rd, Rd^Fds, Rd^Fds, Rd^Fds, Rd^Fds, Rd^Fds, Rd^Fds, Rd^Fds, Rd, Rd, Rd, Rd, Rd, Rd, Rd^Fds, Rd^Fds, Rd^Fds, Rd^Fds, Rd^Fds, Rd^Fds, Gll^Fp, Rd^Fds, Rd^Fds, Rd^Fds, Rd^Fds, Rd^Fds, Rd^Fds, Rd, Rd, Rd, Rd, Rd, Rd
Gg, Rd, Gg, Rd, Rd, Rd, Rd, Rd, Rd, Rd, Gg, Rd, Rd, Rd, Gg^Fds, Rd^Fds, Rd^Fds, Rd^Fds, Rd^Fds, Rd^Fds, Rd, Rd, Rd, Rd, Gg, Rd, Rd, Rd, Rd, Rd^Fds, Rd, Rd^Fds, Rd^Fds, Rd^Fds, Rd^Fds, Rd^Fds, Rd, Rd^Fds, Rd, Rd, Rd, Rd, Rd, Rd, Rd, Rd
